XXXXXXXXXXXXXXXXXXXXXXXXXXX
XWWWWWWWWWWWWWWWWWWWWWWWWWX
XWUFFFFFFFFFFWFFFFFFtFFFFWX
XWFFFFFFFFFFFWFFFFFFFFFFFWX
XWFFFFFFFFFFUWFFFFFFFFFFFWX
XWFFFFFFFFFFFFFFFFFFFFFFUWX
XWFWWWWFWFWWFFFWWFWFWWWWFWX
XWFFFFFFWFFFFWFFFFWFFFFFFWX
XWWWWWWFWWWWFWFWWWWFWWWWWWX
XWXXXXWFWFFFFFFFFFWFWXXXXWX
XWXXXXWFWFWWWGWWWFWFWXXXXWX
XWWWWWWFWFW0RTL2WFWFWWWWWWX
DDXFFFFFFFWRRTLLWFFFFFFFXDD
XWWWWWWFWFWTT1TTWFWFWWWWWWX
XWXXXXWFWFWWWWWWWFWFWXXXXWX
XWXXXXWFWFFFFPFFFFWFWXXXXWX
XWWWWWWFWWWWFWFWWWWFWWWWWWX
XWFsFFFFWFFFFWFFFFWFFFFFsWX
XWFWWWWFWFWWWWWWWFWFWWWWFWX
XWFFFFFFFFFFFFFFtFFFFFFFFWX
XWFFFFFFFFFFFWFFFFFFFFFFFWX
XWFFFFFFFFFFFWFFFFFFFFFFFWX
XWFFFFFFFFFFFWFFFFFFFFFFFWX
XWWWWWWWWWWWWWWWWWWWWWWWWWX
XXXXXXXXXXXXXXXXXXXXXXXXXXX